###########
#........##
#........##
#........##
#...@....##
#........##
#........##
#........##
#........##
###########
